R 1920 1080
NO ./maps/path
SO ./maps/path
WE ./maps/path
EA ./maps/path
S ./maps/path
F 220,100,0
C 225,30,0

        1111111111111111111111111
        1000000000110000000000001
        1011000001110000002000002
        10010000000000N0000000001
111111111011000001110000000000001
100000000011000001110111111111111
11110111111111011100000010001
1111011111111101110101001000000
11000000110101011100000010001
10002000000000001100000010N01
10000000000000001101010010001
110000011101010111110111100111
11110111 1110101 101111010001
11111111 1111111 111111111111