R  600 600

NO textures/colorstone.xpm
SO textures/dark.xpm
EA textures/purplestone.xpm
WE textures/bluestone.xpm

S textures/barrel.xpm

C 21,21,21
F 42,42,42

 1111111111111
10000022000221
12222222222221   
1000000N000000111111
11111100000000000001     1
100000000000000000001   121
10000110000000000021     1
10001  1022222022011  
 11021100002200022021
   11020022220000221
     111111111111111