R 10 10
NO textures/colorstone.xpm
SO textures/bluestone.xpm
EA textures/purplestone.xpm
WE textures/wood.xpm

S textures/barrel.xpm

C 35,51,66
F 206,128,84

11111111111111
10000022000221
12222222222221
10000N00000000111111
11111100000000000001
10000000002222202201
 11020000002200022021
   11020022220000221
     111111111111111