R 500 500
NO textures/colorstone.xpm
SO textures/bluestone.xpm
EA textures/purplestone.xpm
WE textures/dark.xpm

S textures/barrel.xpm

C 35,51,66
F 198,136,74

11111111111111111111111111
10000000000000000000000001
10000000000000000000000001
100000000000001100000000001
10000000000001  10000000001
10000000000000110000000001
10000000000000000000000001
10000000000000000000000001
10000000000000000000000001
10000000000000000000000001
10000000000000000000000001
10000000000000000000000001
10000000000000000000000001
1000000000000000000N000001
11111111111111111111111111