

EA textures/bluestone.xpm

R 500 500

NO textures/purplestone.xpm
WE textures/colorstone.xpm

SO textures/dark.xpm





    C    5,  166,   42  
    S     textures/barrel.xpm
F 0,0, 0            


       111111      
       100S01      
       100001      
       100001      
       100001      
       100001      
       100001      
       100001      
       100001      
       100001      
       100001      
       100001      
       100001      
       100001      
       100001      
       100001      
       100001      
       100001      
       100001      
       111111        