

EA textures/bluestone.xpm

R 500 100

NO textures/purplestone.xpm
WE textures/colorstone.xpm

SO textures/dark.xpm





    C    5,  166,   42  
    S     textures/barrel.xpm
F 0,0, 0            


1111111
          
11111111
11001
  1N1   
   1     