F   42  ,   42   ,  42   

R 500 500
NO textures/colorstone.xpm
SO textures/bluestone.xpm
EA textures/purplestone.xpm
WE textures/dark.xpm

S textures/barrel.xpm

C 35,51,66


11111
10S01
10001
10001
10001
10001
10001
10001
10001
10001
10001
10001
10001
10001
10001
10001
10001
11111