
R 500 500
NO textures/colorstone.xpm
SO textures/bluestone.xpm
EA textures/purplestone.xpm
WE textures/dark.xpm

S textures/barrel.xpm

C 35,051,66  
        F     4,5,    45     

11111
101 1
 11    1
      1N1
1111   1