R 500 100
NO textures/colorstone.xpm
SO textures/bluestone.xpm
EA textures/purplestone.xpm
WE textures/dark.xpm

S textures/barrel.xpm

C 35,51,66
F 206,128,84

11111111 111    11111
1000000110011111E0001
100011010101220111101
1020100000010001100011
1111101110011101 110001
    101 10011101 11101
    111 11011101 11001
         1011001 100001
         1011101111011
         100000000001
          1111111111