R 500 500
NO textures/colorstone.xpm
SO textures/bluestone.xpm
EA textures/purplestone.xpm
WE textures/wood.xpm

S textures/barrel.xpm

C 35,51,66
F 206,128,84

        1111111111111111111111111
        1000020000110000000000001
        1011000001110000002000001
        1001000000000000000000201
111111111011002001110200000000001
100000000011000001110111100011111
11110111111111011100000010001
11110111111111011101010010001
11000000110101011100000010001
10002000000000001100000010001
10200000020000001101010010001
11000001110101011111011112W2111
11110111 1110101 101111010201
11111111 1111111 111111111111