
  R   100 500   
NO textures/colorstone.xpm

SO textures/bluestone.xpm
EA textures/purplestone.xpm
WE textures/dark.xpm

S textures/barrel.xpm

   C 35  ,   51,    66    

F   42    ,42,   42   

        1111111111111111111111111
        1000020000110000000000001
        1000020000110000002000001
        10110000011100000001100001
        1001000000000000001  1001
        1001000000000000001  1001
111111111011002001110200001  10001
10000000001100000111011110011111111
1111011111111101110000001000001
1111011111111101110101001000001
1100000011010101110000001002001
10002000000000001100000010S0001
1020000002000000110101001000001
1100000111010101111101111202111
11110111 1110101 101111010201
11111111 1111111 111111111111