R 500 500
NO textures/colorstone.xpm
SO textures/bluestone.xpm
EA textures/purplestone.xpm
WE textures/wood.xpm

S textures/barrel.xpm

C 35,51,66
F 206,128,84

1111
10001
100N1
11111
    2 