R 500 500
NO textures/colorstone.xpm
SO textures/bluestone.xpm
EA textures/purplestone.xpm
WE textures/wood.xpm

S textures/barrel.xpm

C 35,51,66
F 206,128,84

     11111     
      10021   
1111   111    
1N01
111
 
 
 1    
121       
 1    